#Example: Large parts of Africa and south east Asia
tropical = {
	# Southwest Africa
	1164 1165 1166 1167 1169 1170 1901 2949 798 1168
	# North and West Africa
	1114 1117 1118 1119 1120 1121 1122 1124 1125
	1126 1136 1137 1138 1139 1140 1141 1143 1144 1145 1146 1147
	1149 1150 1151 1152 1153 1154 1155 1161 1162 1163 1249
	# More West Africa
	2238 2242 2248 2250 2252 2254 2256 2258 2278 2290 2292 2294
	2241 2249 2253 2255 2257 2267 2281 2289 2291 2293 2295
	# Africa
	788 1182 1183 1186 1187 1191 1192 1194 1195 1196 1197 1198 1199 1200 1201 1202
	2771 2772 2770 2763 1217 2759 2757 2756
	# India
	516 517 526 529 530 531 533 534 535 537 539 540 543 544 545 546 547 548 549 552 553 561 563 564 568 570 572 573 574 580 
	1947 2026 2028 2029 2030 2037 2038 2039 2041 2043 2048 2049 2050 2057 2080 2081 2083 2084 2089 2091 2092 2099 2100
	2093 2056 1948 2032 2031 2027 2101 536 2046 2035
	#China
	666 2160
	# Pacific Islands
	1235 1236 1237 1238 1239 1240 1241 1242 1243 1244 1245 1792 1986 1987 1988 1989 1990 1991 1992 1993 1994 1995 1996
	1997 1998 1999 2718 2719 2720 2721 2722 2723 2724
	# Indonesia
	617 618 619 620 621 622 623 624 625 626 627 628 629 630 631 632 633 634 635 636 637 638 639 640 641 642 643 644
	645 646 647 648 649 650 651 652 653 654 655 656 658 659 
	2373 2374 2375 2376 2377 2378 2379 2380 2381 2382 2383 2384 2385 2386 2387
	2388 2389 2390 2391 2392 2393 2394 2397 2398 2399 2400 2401 2402 2403 2404
	#More Indonesia
	2673 2674 2675 2676 2677 2678 2679 2680 2681 2682 2683 2684 2685 2686 2687 2688 2689 2690 2691 2692
	2693 2695 2696 2697 2698 2699 2700 2701 2702 2703 2704 2705 2706 2707 2708 2709 2710 2711 2712
	2713 2714 2715 2716 2717 2725
	# Parts of Australia
	2728 2729 2730 2731
	# Amazonas and others
	747 748 758 800 803 815 821 822 2811 2816 2823 2832 2833 2888 2889 2890 2900 2901 2902 2903 2904 2905 2906 2923 2929 2930 2931 2933 2934 2935 2943 2944 2926 2928 2945 2882 2883
	2921 2922 755 754 753 751 2918 2917 2834 801 814 2827 2825 2824 817 818 2817 824 827 826 2819
	759 2891 2898 #Minas Gerais
	2907 2908 2909 2910 2911 2919 #Goias
	2881 2920 #Mato Grosso
	756 757 760 761 2914 2916 #Bahia
	749 2886 2924 2925 2927 #Maranhao
	741 742 743 830 831 2803 2804 2805 2807 2808 2809 2810 2813 2939 #Venezuela
	828 829 2806 #New Andalucia
	744 745 746 2937 2938 #Guyana
	799
	# South East Asia
	606 607 608 609 610 611 612 614 615 1844
	567 579 581 584 585 586 587 588 589 590 591 592 593 594 595 596 597 598 599
	600 601 602 603 604 605 1016 1823 1817 1022 1815
	# Wasteland
	1789 1796 1797 1798 1799 1800 1802 1803 2740
	# Central America
	835 2664 836 2663 2660 837 2661 838 2640 2662 840 839 2637 2653 2636 841 2638 2635 2649 2632 2650 842 843 845 2634 2651 2633 846 2652
	# Mexico
	844 2631 2629 2630 2646 849 2648 2645 2623 2627 851 2643 2657 855
}

arid = {
	#Europe
	217 218 219 225 2754 1748 221 222 2751 1750 220 214

	# Persia
	432 433 434 435 438 447 455 575 576 577 2230 2231 2232 2233 2234
	421 420 424 2205 2207 2211 2210 2209 412 413 414 2212 2215 417 426 428 2213 429 2217 430 2216 2222 2218 2223 2219 431 2220 2214 427 2236 2235 2221 436 445 446 2224 2228 449 2229 2225 450 451 448 2227 2226

	# Arabia
	390 391 392 393 403 404 394 383 384 385 386 389 402 380 381 2327 2328 2329 2330 2331 2332 2335 2336 2337 2338 2339 2340 2343 2344 2345 2347 2346 387 388 1099 401 2342 2341 400 399 398 397 2333 395 396

	# Middle East
	322 323 1848 324 2301 332 2303 407 2314 405 382 418 2308 2309 406 411 415 2310 409 410 2311 2312 408

	# Wasteland	
	1779 1793 1794 1795 1786 1790 1791 2200 2334
	
	# North Africa
	346 347 349 350 351 352 353 355 357 365 1111 1128 1131 1132 1133 1134 1135 1127 2318 2320 2321 2322 2323 2324 2325 2326 2448 2449 2450 2451 2452 2453 2456 2457 2458 2460 2472 2475 2474
	1110 348 2464 2466 2470 344 345 2467 2463 2454 341 2473 
	358 362 363 364 2316 359 361 2315 2317 2319 360

	#The Sahel
	1112 1113 1115 1116 1123 1129 1130 1142 1148 1156 1157 1158 1159
	2237 2240 2243 2244 2245 2246 2247 2259 2260 2261 2262 2263 2264 2265 2268 2269 2270 2271 2272 2273 2274 2275 2276 2277 2279 2282 2284 2287 2288 2239
	2286 1160 2285 2283 2280 2266
	
	# East Africa
	774 1216 1219 1221 1233 1231 1232  1234 1203 1204 1205 1206 1207 1208 1209 1210 1211 1212 1215 1218 1220 1222 1225
	1226 1227 1228 1229 1230 2024
	2768 2791 2760 2761
	2766 2767 2778 2779 2792 2787 2789 2790
	2764 2765 2932 1193
	2773 2774 2775 2776 2777 2780 2781 2782 2783 2784 2785 2786 2788 2793 2794 2795 2796 2797 2798 2799 2800 2801 2802
	
	# Namibia
	1173 1174 1175 1176 1801 2856 2864 2880 1178
	
	# Central Asia 
	437 441 442 444 1784 1785 2349 2350 2363 2352 1969
	2208 2417 464 466 2365 2367 469 470 465 439 443 472 471 2370 2362 440 1973 2351 2353 2358 1970 456 2361 477 459 2368 2360 2364 453 454
	
	#East Asia
	707 710 711 712 739 2121 2122 2123 2124 2192 722
	2120 2119 714 713 718 719 2117 2193 2191 708 706 2134 2182 709 698 720 2747 701 702 693 694 721 723 2114 2115 2136
	
	# India
	503 504 505 506 512 513 514 2088 2064 2066 2078 2079 2086 2074 578 2076 507 2075 510 2065 2062 520 522 524 519 525 2087 518 528 2067 2058 2053 2054 2052 521 2051 515
	542 2090 1949 532 541 2033 569 1946 2034 2036 527
	
	# Mexico
	862 863 864 865 866 867 876 877 878 879 881 882 1808 1809 2009 889 885 859 860 861
	847 2615 857 856 2619 2668
	
	# North America changes
	875 2476 2478 2491 2492 2493 2494 2495 2497 2498 2616 2618 2620 2666 2667
	870 2496 2625 2507 2506 2007 2008 2505 2503 2502 2501
	
	#Australia
	2726 2727 2732
	
	#Patagonia
	780 781 786 2863 2868 2869 2870 2875 2876 2867

	#Brazil
	2912 2913 2915 2885 752 750 491

	#Andes
	2872 2877 2847 2845 2843 2844 791 2842 792 2841 2839 2837 2840 2940 793 2946 795 2941 2835 796 2831 797 2942 805 2828 2829 806 807 809 812 2822 2821 816
}

arctic = {
	# Siberia
	1034 1035 1036 1037 1038 1039 1040 1041 1042 1043 1044 1045 1046 1047 1051 1052 1054 1055 1059 1061 1062 1064 1067 1068 1069
	1070 1072 1073 1074 1077 1080 1963 1964 1032 2427 2425 2426 1780 2445 2428 2429 2433 2430 2432
	2431 2436 2442 2437 2435 2446 2438 2439 2440 1063 1060 2189 2190 2116 717 1056 1057 1058
	
	# North America
	977 978 979 2611 2612
	996 997 998 999 1004 1005 1006 1009	
	2591 2594 2592 2579 2577 2576 2578 2575 2574 2593 2604 2601 2018 2595 

	#South America
	783 782 1095
	
	#Tibet & Manchuria
	705 2102 2103
	
	# Wasteland
	1781 1782 1783  1787 1804 1805 1806 1807 1810 1811 1812 1814
	
	# The Cold North
	370 371 1104 1105 21 18 1777 1776 315 1955 313 23 2752 22 8 10 11 19 27 29 31 32 309 1958 314 1755

	# European Mountains
	176 199 205 1871 165 166 1870 1873 76 1768 128 158 1765 2750
}

#Example: Most of Europe north of med.
mild_winter = {
	# Scandinavia
  	13 14 15 1983 1984
	# German North Sea Coast
	44 54 55 56 1775 1874 1931
	# The Low Countries
	87 88 89 90 91	92 95 96 97 98 99 100 1743 1744 1865
	# France
 	167 168 169 170 171 172 173 174 175 177 178 179 180 182 183 184 185 186 190 191 192 194 195 196
	198 203
	2753 200 202
	# Spain
	206 231 232 1851 228 208 1746 2755 2751 220 213 1748
	# Italy
	103 104 108 111 1769 1875
	114 115 117 118 121 1247
	# Balkans
	130 136 137 155 156 157 160 161 2746 1756 1773 1953 1954 145 146 147 148 149 151 2750
	# British Isles
	233 234 235 236 237 238 239 240 241 243 244 1860 1861 373 374 375 376 247 249 250 253
	# Border with the Med
	141 150 1766
	# Black sea coast
	159 282 284 285 286 287 1764 2405 2406 2410 2411 2412 2413 2414 2447 283
	# Anatolia
	322 323 324 326 411 1848 2300 2301 2308
	2296 2297 318 319 2313 378
	# Central Iran
	416 418 420 421 424 427 428 429 436 446 577 
	444 445 450 453 1968 2228
	# Border of Steppe
	437 439 440 442 443 454 455 456 464 465 466 468 469 471 2197 2352 2356 2362 2363 2365 2367 2370 2409 2416 2417 2350 1973
	# Greater China region
	460 689 693 695 696 697 700 701 703 704 708 713 726 1816 2115 2136 2138
	2169 2177 2180 2182 2183 2184 687 688 1836
	2122 2193 707 706 2134 705 2129 2748 675 2168 680 673 681 672 2173 2171 2172 671 682 683
	686 2146 2175 1838 1821 2145 1822 2176 2144 2143 685 2140 2141 2142 690 691 2139 2137 692 2178 694
	2149 1824 669 2113
	# Hilly bits of Northern India
	448 511 554 570 2069
	# Wintery bits of the west coast
	871 872 890 898 902 
	# Korea and Japan
	733 734 735 736 737 2745
	885 891 899 935 937 940 948 941 950 1012 1013 1818
	1014 1819 1820 1825 1019 1021 1832 1030 1027 1028
	# North Africa
	344 2468 2467 343 338 339
	#
	1774 1827 1974 1970 1969 1879 1877 
	459 461 2368 2117 2191 702 2114 722 718
	# Persian Additions
	2205 2208 2210 2211 2212 2213 2216 2218 2223 2235
	# North America changes
	952 900 916 917 2519 942 943 949 951 953 957 962
	2509 2514 2520 2523 2524 2525 2526 2549 2551 2555 2550 2554 2672
	2011 2545 2546 2548 2481 2479 2478 2491 875 2495 882 2498 2544 933 2547 938
}

#Example: Inland Europe & Scandinavia
normal_winter = {
	# Scandinavia
	1 2 3 6 7 12 16 25 26 34 35 36 37 38 39 1930 1981 1982 1985
	# The Baltic Coast
	40 41 42 43 45 46 47 48 767 770 771
	# Inland Germany
	49 50 51 52 53 57 58 59 60 61 62 63 64 65 66 67 68 69 70 71 72 74 75 77 78 79 80 81 82 83 84 85 86 1757 1758 1759 1760
	1761 1762 1763 1858 1857 1859 1876 1880 1872 1868
	181 1866 93 1742 1878 94 187 188 189 193
	# Austria and the Balkans
	133 134 135 153 154 158 162 1767 1770 1772 1863 1864 143 144 1853
	129 131 152 1826 1828 139 140 1831 1765 268 1869
	# Southern Europe
	197 201 102 101 105 106 116 119 120 207 1745 209 176 199 210 204
	# British Isles
	246 248 251 252 245 372 242 369 1979
	# Poland and Lithunania
	254 255 256 257 258 259 260 261 262 263 264 265 266 267 269 270 271 272 273 274 275 276 277 278 279 280 281 288 289 290 2424
	291 292 1771 2407
	# The not quite so cold parts of the Steppe
	470 472 474 476 477 478 479 2359 467 2415 457 
	#Mongolia
	723 725 728 730 2109 2110 2111 2119 2187 2188 2190
	509 2128 676 715 2120 2131 2133 2106 2112 717 721 2107
	# Siberia
	1032 297 298 300 301 299 302 2408 303
	# Cold bits of the west coast
	889 905 915 946 947 954 955 956 958 959 960 961 963
	964 965 966 967 968 969 970 989
	#
	1951 1952 1940 1939 1841 1938 1935 1936 1937 1842 1834 1960 1941 1942 1943 1944 1945 1966 1967
	1971 2023 2010 2013 508 1017 1018 1830 1026 2395 1843
	2744 1845 2694 1020 1839
	# Persian Additions
	449 2215 2221 2227 2195 2199 425 2207 2214 2236 463 423 2203 2225
	316 317 2299 325 328 2298 2302 327 332
	1846 329 2303
	# Modified NA
	944 987 2584 2585 2670
	2513 2552 2553 2556 2557 2558 2560 2561 2562
	2366 2369 2357 2354 2360 2355 2361 2358 2351 2353 1809
	2485 2482 2477 2480 879 2492 2494 878 2639 945 2521 2522 2586 2587
	873 1808 936 2483 2488 2487 2004 2501 2602 2502 2503 2598 2005 2511 2510 2008 909 2007 903 906 907 2508 901 2625 2512 904 913 914 
}

#Example: Russia & Lappland
severe_winter = {
	# Scandinavia
	4 5 8 9 10 11 17 18 19 20 21 22 23 24 27 28 29 30 31 32 33 2752
	# The Alps
	73 110 165 166 205 1768 1867 1870 1871 1873 128 132 107 76
	# The Pyraneese
	211 212
	# Mother Russia
	293 294 295 296 304 305 306 307 308 309 310 311 312 313 314 315 1752 1753 1754 1755 1776 1777 1778 2102 2103 1048 2749
	473 1965 475 2444 2441
	# The Cold North
	370 371 1104 1105
	# Hindukush & Afghanistan
	451 452 458
	# India
	557 565 1788 2070 2073 2074 2071
	# Siberia
	1034 1035 1036 1037 1038 1039 1040 1041 1042 1043 1044 1045 1046 1047 1051 1052 1054 1055 1059 1061 1062 1064 1067 1068 1069
	1070 1071 1072 1073 1074 1075 1076 1077 1078 1079 1080 1081 1082 1083 2418 2419 2421 2422 2423 2425 1780 2426 2427
	2428 2429 2433 2445 2432 2443 2430 2431 2436 2437 2442 2435 2446 2438 2439 2420 2440 714 2118 2434 480 1065 1063 1060 1056 1057
	# The Caucasus
	422 462 1856 330 2305 331 2196 2204 2304 2306 2307
	# Manchuria & Mongolia & Xinjiang
	716 719 724 727 729 731 1049 1066 1053 1058 2104 2105 2116 2127 2185 2186 2189 739 2742 2743 732 1835 1029 1850 2364 2125 2126 2108 1050
	# Tibet
	677 2130 2167 2132 2135 678 2170
	# Alaska
	974 975 976 977 978 979 908 910 911 912 988 990
	991 992 986 994 995 996 997 998 999 1000 1001 1002 1003 1004 1005 1006 1007 1008 1009 1010 1011
	# Wasteland
	1781 1782 1783 1785 1804 1805 1806 1807 1810 1811 1812 1813 1814 1784 1787 2194
	#
	1961 1959 1957 1956 1958 1955 1964 1962 1963 1972
	2003 2006 2018 2017 2015 2016 2022 138
	# Japan
	1023 1024 1025 1837 1031 1033 1847 1852
	# Persian Additions
	2198 2201 2226 419 2202 2206 417 426 413 414 2217
	# North America additions
	971 980 981 2484 880 874 972 973 2496 993 2566 2570 982 983 984 985 2568 2569
	2009 2012 2019 2020 2486 2504 2505 2506 2507 2517 2518 2559 2563 2572
	2564 2565 2567 2571 2573 2574 2575 2576 2577 2578 2579 2580 2581 2582 2583 2588 2589 2590 2591 2489 2490
	2592 2593 2594 2595 2596 2597 2599 2600 2601 2603 2604 2605 2606 2607 2608 2609 2610 2611 2612 2613 2671
}

impassable = {
	2426 1173 1779 1781 1782 1783 1784 1785 1786 1787 1788 1789 1790 1791 1793 1794 1795 1796 1797 1798 1799 1800 1801 1802 1803 1804 1805
	1806 1807 1808 1810 1811 1812 1814 1950 2025 2194 2200 2251 2334 2608 2740 2425 2936 2001 1895 1896
}
